11111111111111111
101C1000000100011
10001101100001111
1000001P11001C0E1
1000000C10000C111
10001C00000100011
11111111111111111