11111111111111111111111111111111111111111111111111111111111111
1P000000000000001000000000000000010000000000000000000000000001
100000C00000000000000000000000000000000C0000000000000000000001
10000000000000000000010000000000000000000000000000000000000001
10000000000000000000000000000000000000000000C00000000000000001

10000000000000000000000000000000000000000000000000000000000101
100000000100000000000000000000000100000000000000010000000000E1



100000000000000C0000000000000000000000000000000000000000000101
10000000000000000000000000000000000000000000000000000000000001
10000100000000000000000000000000000000000000C00000000000000001
1000000000000C000000000000001000000000000000000000000000000001
11111111111111111111111111111111111111111111111111111111111111