11111111111
101C10000C1
1000CC01101
1000101C111
1000P0EC101
10001C01001
11111111111