111111111111
1C000C000001
1C0100000001
1000C0P00001
100000E00001
111111111111