111111111
100000001
100100001
100000P01
100000001
111111111