11111111111111111
1P0C1000000100011
10000000000000111
10000000C100001E1
10000000000000001
10001C00000100011
11111111111111111