111111111
10000C001
100100001
1000C0P01
100000E01
111111111