11111111111111111
100C1000000100011
10000P00000000111
10000000C100001E1
10000000000000001
10001C00000000011
11111111111111111