11111111111
1P000000001
10000F00001
10000000001
10C000000E1
11111111111